1111111111111111111
10000C0EC000C00C001
100C0010000C1001001
1C00C00000100000001
1100P0000000C000001
1111111111111111111