1111111111111111111
1P000C0000000000C01
100C0010000C1001001
1C00C00000100000001
110001001000C010E01
1111111111111111111