1111111111111111111
1P000C00C000C00CE01
100C0010000C1001001
1C00C00000100000001
110000001000C010001
1111111111111111111