1111111111111111111
1CCCCCCECCCCCCCPCC1
1CCC0C0CC0C010C0CC1
1C0C0CCC0C0CCC0CC01
110C0C0C0CCC0C0C0C1
1111111111111111111