1111111111111111111
1000000E00000000001
1000001000001001001
10000000C0100000001
1100P00000000000001
1111111111111111111