1111111
1P000C1
100C001
1C00C01
10000P1
1111111