11111111111111111111111111111111111
111ECCCCCCCCCCCCCCCCCCCCCCCC1111111
1P1111111111111111111111111C1111111
1CCCCCCCCCCCCCCCCCCCCCCCCCCC1111111
11111111111111111111111111111111111