11111111111111111111111111111111111111111111111111111111111111111111
100000000000000C00000C0000000000000010010100100000100001C00000C00101
101C01010010000010100100C0000101011010010000100C00001001000000010101
1E10010010101010001001000000010101C00001010010000010100100000C010C01
1P0000000C00C0000000C00000C00000C110100001C000C00010100C000000010101
11111111111111111111111111111111111111111111111111111111111111111111