1111111111111111111111111111111111111111111111111111111111111111111111111111111111111111111111111111
1C0011C0011C0011C0011C0011C0011C0011C0011C0011C0011C0011C0011C0011C0011C0011C0011C0011C0011C0011C001
100011000110001100011C0011C0011C0011C0011C0011C0011C0011C0011C0011C0011C0011C0011C0011C0011C0011C001
1P0011P0011P0011P00111001110011100111001110011100111001110011100111001110011100111001110011100111001
1100111001110011100110011100111001110011100111001110011100111001110011100111001110011100111001110011
1001110011100111001110001100011000110001100011000110001100011000110001100011000110001100011000110001
110011100111001110011C0011C0011C0011C0011C0011C0011C0011C0011C0011C0011C0011C0011C0011C0011C0011C001
100111001110011100111P0011P0011P0011P0011P0011P0011P0011P0011P0011P0011P0011P0011P0011P0011P0011P001
110011100111001110011P0011P0011P0011P0011P0011P0011P0011P0011P0011P0011P0011P0011P0011P0011P0011P001
100111001110011100111P0011P0011P0011P0011P0011P0011P0011P0011P0011P0011P0011P0011P0011P0011P0011P001
1100111001110011100111001110011100111001110011100111001110011100111001110011100111001110011100111001
1E0111E0111E0111E0111C0011C0011C0011C0011C0011C0011C0011C0011C0011C0011C0011C0011C0011C0011C0011C001
1E0111E0111E0111E0111C0011C0011C0011C0011C0011C0011C0011C0011C0011C0011C0011C0011C0011C0011C0011C001
1E0111E0111E0111E0111C0011C0011C0011C0011C0011C0011C0011C0011C0011C0011C0011C0011C0011C0011C0011C001
1E0111E0111E0111E0111C0011C0011C0011C0011C0011C0011C0011C0011C0011C0011C0011C0011C0011C0011C0011C001
1E0111E0111E0111E0111C0011C0011C0011C0011C0011C0011C0011C0011C0011C0011C0011C0011C0011C0011C0011C001
1E0111E0111E0111E0111C0011C0011C0011C0011C0011C0011C0011C0011C0011C0011C0011C0011C0011C0011C0011C001
1E0111E0111E0111E0111C0011C0011C0011C0011C0011C0011C0011C0011C0011C0011C0011C0011C0011C0011C0011C001
1E0111E0111E0111E0111C0011C0011C0011C0011C0011C0011C0011C0011C0011C0011C0011C0011C0011C0011C0011C001
1E0111E0111E0111E0111C0011C0011C0011C0011C0011C0011C0011C0011C0011C0011C0011C0011C0011C0011C0011C001
1E0111E0111E0111E0111C0011C0011C0011C0011C0011C0011C0011C0011C0011C0011C0011C0011C0011C0011C0011C001
1E0111E0111E0111E0111C0011C0011C0011C0011C0011C0011C0011C0011C0011C0011C0011C0011C0011C0011C0011C001
1E0111E0111E0111E0111C0011C0011C0011C0011C0011C0011C0011C0011C0011C0011C0011C0011C0011C0011C0011C001
1E0111E0111E0111E0111C0011C0011C0011C0011C0011C0011C0011C0011C0011C0011C0011C0011C0011C0011C0011C001
1E0111E0111E0111E0111C0011C0011C0011C0011C0011C0011C0011C0011C0011C0011C0011C0011C0011C0011C0011C001
1E0111E0111E0111E0111C0011C0011C0011C0011C0011C0011C0011C0011C0011C0011C0011C0011C0011C0011C0011C001
1E0111E0111E0111E0111C0011C0011C0011C0011C0011C0011C0011C0011C0011C0011C0011C0011C0011C0011C0011C001
1E0111E0111E0111E0111C0011C0011C0011C0011C0011C0011C0011C0011C0011C0011C0011C0011C0011C0011C0011C001
1E0111E0111E0111E0111C0011C0011C0011C0011C0011C0011C0011C0011C0011C0011C0011C0011C0011C0011C0011C001
1E0111E0111E0111E0111C0011C0011C0011C0011C0011C0011C0011C0011C0011C0011C0011C0011C0011C0011C0011C001
1E0111E0111E0111E0111C0011C0011C0011C0011C0011C0011C0011C0011C0011C0011C0011C0011C0011C0011C0011C001
1E0111E0111E0111E0111C0011C0011C0011C0011C0011C0011C0011C0011C0011C0011C0011C0011C0011C0011C0011C001
1E0111E0111E0111E0111C0011C0011C0011C0011C0011C0011C0011C0011C0011C0011C0011C0011C0011C0011C0011C001
1E0111E0111E0111E0111C0011C0011C0011C0011C0011C0011C0011C0011C0011C0011C0011C0011C0011C0011C0011C001
1E0111E0111E0111E0111C0011C0011C0011C0011C0011C0011C0011C0011C0011C0011C0011C0011C0011C0011C0011C001
1E0111E0111E0111E0111C0011C0011C0011C0011C0011C0011C0011C0011C0011C0011C0011C0011C0011C0011C0011C001
1E0111E0111E0111E0111C0011C0011C0011C0011C0011C0011C0011C0011C0011C0011C0011C0011C0011C0011C0011C001
1E0111E0111E0111E0111C0011C0011C0011C0011C0011C0011C0011C0011C0011C0011C0011C0011C0011C0011C0011C001