1111111111111
1C00010000001
11P00000C0001
1000C00100001
10000C0000001
1000000000C01
1111111011111
1000CC0000001
1000000C10101
10000C0000001
100C000000E01
1000000C00001
1111111111111