1111111111111
1C0001000E001
11P00000C0001
1000C00100001
10000C0000001
1000000000C01
1111100111111
1000CC0000001
1000000C10101
10000C0000001
100C000000001
1000000C00001
1111111111111