1111111111111
1C0P010000001
11100000C0001
1000C00100001
10000C0000001
1000000000C01
1111110111111
1000CC0000001
1000000C10101
10000C0000001
111C000000001
1CE0000C00001
1111111111111