111111111111111111111
1P0000000000000000E01
101111011111011111101
1C00H000C0H00C0000C01
101111011111011111101
100000000H00000000001
111011111110111011111
1C000000000H0000000C1
111011111110111011111
10000000H0H0000000001
101111011111011111101
1C000000C0000C0000C01
101111011111011111101
1H000000000H000000001
101111011111011111101
10000000H000000000001
1C000000C0000C0000C01
101111011111011111101
100000000H00000000C01
111111111111111111111