111111111111111111111111111111111111
10P000000000C00000000000000000C00101
111C01010010000010100100C00000010101
10E00100101010100010010000000C010C01
110000000C00C00000C0C0C00000C0000001
111111111111111111111111111111111111