11111111111111111111111111111111111111111111111111111111111111111111
10P000000000H000000000000000C000000010010100100000100001C00000C00101
111C01010010000010100100C0000101011010010000100C00001001000000010101
10E0010010101010001001000000010101C00001010010000010100100000C010C01
110000000C00C00000C0C0C000C00000C111100000000000001010000000000000H1
11111111111111111111111111111111111111111111111111111111111111111111