11111111111111111111111111111111111111111111111111111111111111111111
1P00CC00H000000C00000C00000000H00C0010010100100000100001C00000C00101
111C01010010000010100100C0000101011010010000100C00001001000000010101
1E00010010101010001001000000010101C00001010010000010100100000C010C01
110000H00C00C00000C0C00H00C00000C110100001C000C00010100C0000H0010101
11111111111111111111111111111111111111111111111111111111111111111111