1111111111111111111111111111111111
1E10000H0000000C00000C0000H0000001
1010010100100000101001000000010101
1010010010101010001001000000010101
1P00H0000C00C00000000000000H0000C1
1111111111111111111111111111111111